64 64
1111111111111111111111111111111111111111111111111111111111111111
1000000000000001100000000000000000000000000000000000000000000001
1e01111111111101100111111111111111111111111111111111111111111111
1000000000000001100000000000000000000000000000000000000000000m01
1011111111111101101111111111111111111111111111111111111111111111
1000000000000001100000000000000000000000000000000000000000000001
1001111111111101100111111111111111111111111111111111111111111111
1000000000000001100000000000000000000000000000000000000000000001
1011111111111101101111111111111111111111111111111111111111111111
1000000000000001100000000000000000000000000000000000000000000001
1001111111111101100111111111111111111111111111111111111111111111
1000000000000001100000000000000000000000000000000000000000000001
1011111111111101101111111111111111111111111111111111111111111111
1000000000000001100000000000000000000000000000000000000000000001
1011111111111111100000000000000000000000000000000000000000000001
1011111111111111101111111111111111111111111111111111111111111111
1011111111111111101111111111111111111111111111111111111111111111
1000000000000001100000000000000000000000000000000000000000000001
1001111111111101100111111111111111111111111111111111111111111111
1000000000000001100000000000000000000000000000000000000000000001
1011111111111101101111111111111111111111111111111111111111111111
1000000000000001100000000000000000000000000000000000000000000001
1001111111111101100111111111111111111111111111111111111111111111
1000000000000001100000000000000000000000000000000000000000000001
1011111111111101101111111111111111111111111111111111111111111111
1000000000000001100000000000000000000000000000000000000000000001
1001111111111101100111111111111111111111111111111111111111111111
1000000000000001100000000000000000000000000000000000000000000001
1011111111111101101111111111111111111111111111111111111111111111
1000000000000000000000000000000000000000000000000000000000000001
1111111111111111100000000000000000000000000000000000000000000001
1111111111111111111111111111111111111111111111111111111111111111
1111111111111111111111111111111111111111111111111111111111111111
1111111111111111111111111111111111111111111111111111111111111111
1000000000000000000000000000000000000000000000000000000000000001
1001111111111101100111111111111111111111111111111111111111111111
1000000000000001100000000000000000000000000000000000000000000001
1011111111111101101111111111111111111111111111111111111111111111
1000000000000001100000000000000000000000000000000000000000000001
1001111111111101100111111111111111111111111111111111111111111111
1000000000000001100000000000000000000000000000000000000000000001
1011111111111101101111111111111111111111111111111111111111111111
1000000000000001100000000000000000000000000000000000000000000001
1001111111111101100111111111111111111111111111111111111111111111
1000000000000001100000000000000000000000000000000000000000000001
1011111111111101101111111111111111111111111111111111111111111111
1000000000000001100000000000000000000000000000000000000000000001
1011111111111111100000000000000000000000000000000000000000000001
1011111111111111101111111111111111111111111111111111111111111111
1011111111111111101111111111111111111111111111111111111111111111
1000000000000001100000000000000000000000000000000000000000000001
1001111111111101100111111111111111111111111111111111111111111111
1000000000000001100000000000000000000000000000000000000000000001
1011111111111101101111111111111111111111111111111111111111111111
1000000000000001100000000000000000000000000000000000000000000001
1001111111111101100111111111111111111111111111111111111111111111
1000000000000001100000000000000000000000000000000000000000000001
1011111111111101101111111111111111111111111111111111111111111111
1000000000000001100000000000000000000000000000000000000000000001
1001111111111101100111111111111111001111111111101100111111111111
1001111111111101100111111111111110000000000000000000000000000001
0000000000000000000000000000000000000000000000000000011111111111
0000000111111111110000000000011111111110000000000000011111111101
1111111111111111111111111111111111111111111111111111111111111111
