16 16
1111111111111111
1000000000000001
0e01111111111101
1000000000000001
1011111111111101
1000000000000001
1001111111111101
1000000000000001
1011111111111101
1000000000000001
1001111111111101
10000000m0000001
1011111111111101
1000000000000001
1111111111111111
1111111111111111