8 8
11101110
000e0001
m0010001
00000000
11101110
00000001
00010001
11111111